#################################################
#...#...#.....#.....#...#.#...#...........#.....#
###.###.###.#.#####.###.#.#.###.#.#.#.#.###.###.#
#.#.......#.#.#.#......o........#.#.#.#.......#.#
#.#.#####.###.#.#.#.#.###.#.#.###.#########.#.#.#
#.#.#.#.......#.#.#.#...#.#.#...#.#.......#.#.#.#
#.###.#######.#.#.#.###.#.#.#.#.###.#####.#.#####
#...#...#...#.....#...#.#.#.#.#...#.....#.#.....#
#.#.#.#.#.#.###.#.#.###.#.#.###.###.###.#####.#.#
#.#...#...#.....#.#...#.#.#...#.......#.....#.#.#
#####.#.#.#.#.###.#.###.#.#.#.#.#.#####.#.#.#.#.#
#.....#.#.#.#.#...#...#.#.#.#.#.#.....#.#.#.#.#.#
#####.#.###.#.###.#.###########.#######.#########
#.....#.#...#.#...#...........#.......#.........#
#.###.#.###.###.###.#.###.#.#.#.###.#########.###
#.#...#.#...#.....#.#...#.#.#.#.#.#.........#...#
#####.#######.#######.###########.#####.#########
#.#...#...........#.........#.........#.......#.#
#.#####.#.#.#.#.#.#.###.###.#.###.#########.###.#
#.......#.#.#.#.#.#...#...#.....#.........#.#.#.#
#.###.#.#######.#.###.#.###.#####.###########.#.#
#...#.#...#.....#...#.#...#.....#...............#
#.#####.#.###.###.###.#.###.#.#######.#.#.#####.#
#.#.....#.#.....#.#...#...#.#.......#.#.#.....#.#
#.#.###.#.#.#.#.#####.#.###.###.#.#.#####.#.#.#.#
#.#...#.#.#.#.#.....#.#.#...#...#.#.....#.#.#.#.#
###.#.###.#.#.#.#.#####.#.#####.#.#######.#.#.#.#
#...#...#.#.#.#.#.....#.#...#...#.......#.#.#.#.#
#.#.#.###.#.###.#.#######.#.#.#.#.#######.###.#.#
#.#.#.#...#.#...#.....#...#.#.#.#.....#.#...#.#.#
#.#.#######.#.#.###########.#.#.#.#.###.###.###.#
#.#.....#...#.#.....#.#.....#.#.#.#.....#.....#.#
#.#.#.#######.#.###.#.#.#.#.#.#.#.#.###.###.###.#
#.#.#.#.......#.#.....#.#.#.#.#.#.#...#...#.#...#
#.#.#.#.#.#.###.#.#.#.#########.#.#.#.#######.#.#
#.#.#.#.#.#...#.#.#.#.........#.#.#.#.......#.#.#
#.#.###.#.###.#.#.#.#.#.###.#.#.#.#.#.#.#.###.###
#.#...#.#.#...#.#.#.#.#...#.#.#.#.#.#.#.#.#....##
#.#.#####.#.#.###.###.#.#.#.###.#.#.#.#########.#
#.#.....#.#.#.#...#...#.#.#.#...#.#.#.#.#.......#
#.#####.###.#.#.###.#######.#.###.#.###.#####.#.#
#...#...#...#.#.#.......#...#.#...#.........#.#.#
#.#####.#.###.###.#.#####.#.#.#.#.#.#.###.###.#.#
#...#...#.#...#...#...#...#.#.#.#.#.#...#...#.#.#
###.###.#.#.###.#.###.#.#.###.#.#.#.#.###.#.#.###
#...#...#.#...#.#...#.#.#.#...#.#.#.#...#.#.#...#
#.#.#.#.#.#.#.###.###.#####.#.###.#.#.#####.#####
#.#.#.#.#.#.#...#.#.......#.#.#...#.#...#.......#
#################################################
